%%%%%%%%%%%%%%%%%%%%
%o   %   .    %    %
% %% % %%%%%% %% % %
% %              % %
% % %% %%  %% %% % %
%       G  G     % %
% % %% %%%%%% %% % %
% %      .       % %
% %% % %%%%%% % %% %
%    %   PP   %    %
%%%%%%%%%%%%%%%%%%%%