%%%%%%%%%%%%%%%%%%%%
%.           ..%   %
%.%%%.%%%%.%%%%% % %
%        P       % %
%%%%%%%%%%%%%%%%%% %
%.....             %
%%%%%%%%%%%%%%%%%%%%
